1111001111
0010001101
0111111001
0010000011
0011110001
0000000001
0010111111
1001000001
1010000001
1111111111