11111111111111
10310000000001
10010001111111
10010001130001
10010001100001
10010001100001
10000001100001
10000000000001
10010000000001
13010000000001
11110111110001
10000000000001
10000000020001
10000000000001
11111111111111