11111111111111
1W10000000S0W1
1S110111111101
1010010000J101
101011011101S1
10101001000101
10100011010101
10001000010001
10111111110101
1J000000000101
11101111110101
10001000000101
10101011111111
1W100000000EW1
11111111111111