11111111111111
1W0000000000W1
1S111111111101
1110010000J101
10101101110101
10101001E10101
10100011010101
10001000000001
10111111110101
1J000000000101
11101111110101
10001000000101
101010111111S1
1W1000000000W1
11111111111111