11111111111111
1W0000000000W1
1S1111001111S1
10100000000101
101001001J0101
10100100100101
10100000000101
100001J0100101
101001W0100001
10100000000101
10100100100101
1011110010E101
101J0000011101
1W000000000JW1
11111111111111